Is it better to go around or open the door? The optimist and the pessimist disagree on this point, even with omniscient vision.
[21 14]
WWWWWWWWWWWWWWWWWWWWW
WWWWWWWWWWWWWWWWWWWWW
WWWWWWWWWWWWWWWWWWWWW
WWWWWWWWW   WWWWWWWWW
WWWWWWWWWKWbWWWWWWWWW
WWWWWWWWW W WWWWWWWWW
WWWWWWWWWBW WWWWWWWWW
WWWWWWWWW W WWWWWWWWW
WWWWWWWWWPW WWWWWWWWW
WWWWWWWWW W WWWWWWWWW
WWWWWWWWW   WWWWWWWWW
WWWWWWWWWWWWWWWWWWWWW
WWWWWWWWWWWWWWWWWWWWW
WWWWWWWWWWWWWWWWWWWWW
