A rigid goals ordering leads to an exhaustive exploration of doors!
[21 14]
WWWWWWWWWWWWWWWWWWWWW
WWWWWWWWKWWWWWrWWWWWW
WWWWWWWW WWWWW WWWWWW
WWWWWWWW       WWWWWW
WWWWWWWWRWYWGWBWWWWWW
WWWWWWWW W   W WWWWWW
WWWWWWWW W W W WWWWWW
WWWWWWWW W W   WWWWWW
WWWWWWWW W WWW WWWWWW
WWWWWWWW W WbWPWWWWWW
WWWWWWWW W WyW WWWWWW
WWWWWWWW    gW WWWWWW
WWWWWWWWWWWWWWWWWWWWW
WWWWWWWWWWWWWWWWWWWWW
