The pessimistic wonders: why making it simple when you can keep it complicated?
[21 14]
WWWWWWWWWWWWWWWWWWWWW
W           W   W   W
W WWWWWWW W W W W WPW
W     W   W   W   W W
WWWWW W WWWWWWWWWWWRW
W W   W W     W  rW W
W W WWW W WWW W WWWKW
W W   W     W W     W
W WWW WWWWWWWWWWWWW W
W   W W     W     W W
W W W W WWW W W W W W
W WWW W W W W W WWW W
W       W     W     W
WWWWWWWWWWWWWWWWWWWWW
