For once pessimism pays!
[21 15]
WWWWWWWWWWWWWWWWWWWWW
WK  W               W
W W W WWWWWWWWWWWWW W
WRW   W             W
W WWGWWYWWW WWWWWWWWW
WPW   W rgW         W
W W W WWWWWWWWWWWWW W
WyW W W   W   W   W W
W W W W W W W W W W W
W D W   W W W   W   W
WWWWWWWWW W WWWWWWWWW
W         W         W
W WWWWWWWWWWWWWWWWW W
W                   W
WWWWWWWWWWWWWWWWWWWWW
