The green door allows him to rescue the princess, but with a rigid ordering of goals he cannot resist opening all the doors before the green one.
[21 14]
WWWWWWWWWWWWWWWWWWWWW
W  ryb  WgWWWWWWWWWWW
W   P   W WWWWWWWWWWW
W       W WWWWWWWWWWW
W       W WWWWWWWWWWW
WGWYWBWRWDWWWWWWWWWWW
W         WWWWWWWWWWW
W   K     WWWWWWWWWWW
W         WWWWWWWWWWW
WWWWWWWWWWWWWWWWWWWWW
WWWWWWWWWWWWWWWWWWWWW
WWWWWWWWWWWWWWWWWWWWW
WWWWWWWWWWWWWWWWWWWWW
WWWWWWWWWWWWWWWWWWWWW
