With an omniscient vision, only the optimistic knight with a rigid goals ordering chooses to open the door
[21 14]
WWWWWWWWWWWWWWWWWWWWW
WWWWWWWWWWWWWWWWWWWWW
WWWWWWWWWWWWWWWWWWWWW
WWWWWWWWW   WWWWWWWWW
WWWWWWWWWKW WWWWWWWWW
WWWWWWWWW W WWWWWWWWW
WWWWWWWWWBWbWWWWWWWWW
WWWWWWWWW W WWWWWWWWW
WWWWWWWWWPW WWWWWWWWW
WWWWWWWWW W WWWWWWWWW
WWWWWWWWW   WWWWWWWWW
WWWWWWWWWWWWWWWWWWWWW
WWWWWWWWWWWWWWWWWWWWW
WWWWWWWWWWWWWWWWWWWWW
