What keys does he really need?
[21 14]
WWWWWWWWWWWWWWWWWWWWW
Wg    W   W         W
WWWWW W W WWWWWWW W W
Wrb W W W       W W W
WWWYWDW WWWWWWW W WWW
W   R   W     W W G W
W WWWWWWW W WWW W W W
W       W W     W WyW
W WWWWW W WWWWWWW W W
W   WKW W     W   B W
WWW W W WWWWW W WWW W
W     W         WP  W
WWWWWWWWWWWWWWWWWWWWW
WWWWWWWWWWWWWWWWWWWWW
