For once pessimism pays!
[21 14]
WWWWWWWWWWWWWWWWWWWWW
W   W G   W   D W   W
W W W W y W P W W W W
W W W W   W   W   W W
W W W WWWWWWBWWWWWW W
W WKW   W    rW     W
W WWWWW W W WWW WWWWW
W W   W W W Y W     W
W W W W W W W WWWWW W
W   W W W W W     W W
W WWW W W W WWWWWbW W
W WgW W W W W   WWW W
W R W     W   W     W
WWWWWWWWWWWWWWWWWWWWW
