Is really the green key necessary?
[21 14]
WWWWWWWWWWWWWWWWWWWWW
Wr    W      bW     W
WWWWW W WWWWWWW WWWBW
W     W       W W   W
W WWWWWWWWWWW W W WWW
W   W       WDW W WyW
WWWGW WWWWW   W W W W
WWW   R  PWWWWW W W W
WWWWW W   W     W W W
W  KW W g Y W WWW W W
W WWW WWWWWWW W   W W
W W     W   W W WWW W
W   WWW   W   W     W
WWWWWWWWWWWWWWWWWWWWW
