The pessimistic wonders: why making it simple when you can keep it complicated?
[21 15]
WWWWWWWWWWWWWWWWWWWWW
WK rW               W
W W W WWWWWWWWWWWWW W
WRW   W             W
W WWWWW WWWWWWWWWWWWW
WPW   W             W
W W W WWWWWWWWWWWWW W
W W W W   W   W   W W
W W W W W W W W W W W
W   W   W W W   W   W
WWWWWWWWW W WWWWWWWWW
W         W         W
W WWWWWWWWWWWWWWWWW W
W                   W
WWWWWWWWWWWWWWWWWWWWW
