Mission: impossible!
[21 15]
WWWWWWWWWWWWWWWWWWWWW
WKW     W W         W
W WWWWW W W WWWWWWW W
W W     W W W     W W
W W WWWWW W W W WWW W
W W W   W   W W W   W
W W WWW WWWWW W W WWW
W W     W   W W   W W
W WWW WWW W W WWWWW W
W W W     W W W     W
WBW WWWWWWW W W WWW W
WPW W     W   W W   W
W W WW  W WWWWWWW W W
W W     W         W W
WWWWWWWWWWWWWWWWWWWWW
